**XX********
XXXXXX******
*XX*********
************
************
******W*****
***W********
************
*****C******
************
**W*********
*W**********
**W******00*
********000*
*********0**
************

* - пустая клетка
0 - озера
X - горы
C - центр города
W - болото

Очков: 