XXXXX*****B*
XXX*******BB
*********BBB
************
***W***W**W*
******WWW***
**W*********
******C*****
************
************
********DDDD
***DDDDDW***
DDD*********
***********#
*********###
********##**
C - центр города
* - пустая клетка
B - Плодородная земля
# - озеро
X - горы
W - болота
R - Дорога