XXXXX*****XX
XXX*****XXX*
*******XXX**
************
***W********
******W*****
**W******#**
*******###**
*********##*
WW**C****##*
**WWWW****##
***BB*WWW**#
*BBBB*******
**BB*******#
*********###
********##**
C - центр города
* - пустая клетка
B - Плодородная земля
# - озеро
X - горы
W - болота