**XX********
XXXXXX******
*XX*********
************
************
******W*****
***W*****X**
************
*****C****X*
************
**W*****X***
*W**********
**W******00*
********000*
*********0**
************