XXXXX*****B*
XXX*******BB
*********BBB
************
***W***W**W*
**X***WWW***
**W**X******
******C*W**X
**X*********
**X****X****
********BBBB
***BBBBW****
BB*********X
***********0
***X***X*0*0
********00**