XXXXX*****B*
XXX*******BB
*********BBB
************
***W***W**W*
******WWW***
**W*********
******C****X
************
**X******X**
********BBBB
***BBBBW****
BB*********X
***********0
***X*****000
********00**