XXXXX*****XX
XXX*****XXX*
*******XXX**
************
***W********
******W*****
**W******B**
*******BBB**
*********00*
WW**C****00*
**WWWW****BB
***BB*WWW**0
*BBBB*******
**BB*******B
*********BBB
********BB**